**************************
*       *        *       *
* *   * *  *             *
******* *  ************* *
*       *  *     *     * *
*  ******        *     * *
*       *        *     * *
***** * *  ****  *  *  * *
*     * *     *     *    *
* * *** *  *  *  ****  ***
* *   * *  *  *     *    *
* *   * *  *  *     *    *
* ***** ******************
*             *  *       *
*  *  *********  *  *    *
*  *  *          *  * ****
*  *  *          *  *    *
****  **** ****  **** ** *
*             *        * *
*  ************  ******* *
*  *             *       *
**************************