********************
*                  *
*      *          *
* *     *     **** *
* *     *     **** *
* ****  *     **** *
* ****  ***** **** *
* ****  *     **** *
* ****  * *   **** *
* *     * *        *
* *     * *        *
* *     * * *** ** *
*       * * *** ** *
* *****   * *** ** *
* *****   * *** ** *
*         *     ** *
*   ***         ** *
*         ***      *
*                  *
********************